20 20
9 1 1 1 1 1 3 9 1 1 1 1 1 1 1 1 1 1 1 3
8 0 0 0 0 0 2 8 0 0 0 0 0 0 0 0 0 0 0 2
8 0 0 0 0 0 2 8 0 0 0 0 0 0 0 0 0 0 0 2
8 0 0 0 0 0 2 8 0 0 0 0 0 0 0 0 0 0 0 2
8 0 0 0 0 0 2 8 0 0 0 0 0 0 0 0 0 0 0 2
8 0 0 0 0 0 0 0 0 0 0 0 0 0 0 0 0 0 0 2
12 4 4 4 4 4 6 8 0 0 0 0 0 0 0 0 0 0 0 2
9 1 1 1 1 1 1 0 0 0 0 0 0 0 0 0 0 0 0 2
8 0 0 0 0 0 0 0 0 0 0 0 0 0 0 0 0 0 0 2
8 0 0 0 0 0 0 0 0 0 0 0 0 0 0 0 0 0 0 2
8 0 0 0 0 0 0 0 0 0 0 0 0 0 0 0 0 0 0 2
8 0 0 0 0 0 0 0 0 0 0 0 0 0 0 0 0 0 0 2
8 0 0 0 0 0 0 0 0 0 0 0 0 0 0 0 0 0 0 2
8 0 0 0 0 0 0 0 0 0 0 0 0 0 0 0 0 0 0 2
8 0 0 0 0 0 0 0 0 0 0 0 0 0 0 0 0 0 0 2
8 0 0 0 0 0 0 0 0 0 0 0 0 0 0 0 0 0 0 2
8 0 0 0 0 0 0 0 0 0 0 0 0 0 0 0 0 0 0 2
8 0 0 0 0 0 0 0 0 0 0 0 0 0 0 0 0 0 0 2
8 0 0 0 0 0 0 0 0 0 0 0 0 0 0 0 0 0 0 2
12 4 4 4 4 4 4 4 4 4 4 4 4 4 4 4 4 4 4 6