14 12
15 15 15 15 15 11 15 15 11 15 15 15 15 15
15 15 15 15  9  0  1  1  0  3 15 15 15 15
15 15 15 15 12  0  4  4  0  6 15 11 15 15
15  9  1  3  9  4  1  1  4  3  9  0  3 15
13  0  0  2 10  9  0  0  3  8  4  4  6 15
15 12  4  4  2  8  0  0  2  8  5  5  7 15
15 13  5  5  2  8  0  0  0  2  9  1  3 15
15  9  1  3  8  0  0  0  2 10  8  0  2 15
13  0  0  0  2 12  0  0  6  8  0  0  0  7
15 12  0  6 12  1  0  0  1  6 12  4  6 15
15 15 14 15  9  2  8  2  8  3 15 15 15 15
15 15 15 15 12  6 12  6 12  6 15 15 15 15